//####///
###  ####
#     $ #
#    #$ #
# . .#  #
#########