//####///
###  ####
#     $ #
# #  #$ #
# . .#  #
#########