//####///
###  ####
#       #
# #  #  #
# . .#  #
#########