/////////////////////
/////#####///////////
/////#   #///////////
/////#$  #///////////
///###  $##//////////
///#  $ $ #//////////
/### # ## #///######/
/#   # ## #####  ..#/
/# $  $          ..#/
/##### ### # ##  ..#/
/////#     #########/
/////#######/////////
/////////////////////