#####/####//////
#...#/#  ####///
#...###  $  #///
#....## $  $###/
##....##   $  #/
###... ## $ $ #/
# ##    #  $  #/
#  ## # ### ####
# $ # #$  $    #
#  $   $    $  #
#   # $ $$ $ ###
#  ######  ###//
# ##////####////
###/////////////